tileswide 64
tileshigh 64
tilewidth 16
tileheight 16

layer 0
16,16,16,16,16,16,16,16,16,16,16,16,16,16,16,16,16,0,16,16,16,16,16,16,16,16,16,16,16,16,16,16,16,16,16,16,16,0,16,16,16,16,16,16,0,16,16,16,16,16,16,16,16,16,16,16,16,16,16,16,16,16,16,16,
16,0,0,0,16,0,0,0,0,0,0,0,16,0,0,0,0,0,0,0,16,0,0,0,0,0,0,0,16,0,0,0,16,0,0,0,16,0,0,0,0,0,0,0,0,0,0,0,16,0,0,0,16,0,0,0,16,0,0,0,0,0,0,16,
16,0,0,0,16,0,0,0,16,0,0,0,16,0,0,0,0,0,0,0,16,0,0,0,0,0,0,0,16,0,0,0,16,0,0,0,16,0,0,0,0,0,0,0,0,0,0,0,16,0,0,0,16,0,0,0,16,0,0,0,0,0,0,16,
0,0,0,0,16,0,0,0,16,0,0,0,16,0,0,0,0,0,0,0,16,0,0,0,0,0,0,0,0,0,0,0,16,0,0,0,16,0,0,0,0,0,0,0,0,0,0,0,16,0,0,0,16,0,0,0,16,0,0,0,16,0,0,16,
16,16,16,16,16,16,16,16,16,16,16,16,16,0,16,16,16,0,16,16,16,16,16,16,16,16,16,16,16,16,16,16,16,0,16,16,16,16,16,16,16,16,16,16,16,16,0,0,16,16,0,0,16,0,0,0,16,16,16,16,16,16,16,16,
16,0,0,0,16,0,0,0,16,0,0,0,16,0,0,0,16,0,0,0,16,0,0,0,0,0,0,0,16,0,0,0,16,0,0,0,16,0,0,0,0,0,0,0,0,0,0,0,16,0,0,0,16,0,0,0,16,0,0,0,16,0,0,16,
16,0,0,0,16,0,0,0,16,0,0,0,16,0,0,0,16,0,0,0,16,0,0,0,0,0,0,0,16,0,0,0,16,0,0,0,16,0,0,0,0,0,0,0,0,0,0,0,16,0,0,0,16,0,0,0,16,0,0,0,16,0,0,16,
16,0,0,0,0,0,0,0,16,0,0,0,16,0,0,0,16,0,0,0,16,0,0,0,0,0,0,0,16,0,0,0,16,0,0,0,16,0,0,0,0,0,0,0,0,0,0,0,16,0,0,0,16,0,0,0,16,0,0,0,16,0,0,16,
16,0,0,0,16,16,16,16,16,16,16,16,16,0,16,16,16,0,16,16,16,16,16,16,16,16,16,16,16,16,16,16,16,16,16,16,16,16,16,16,16,0,0,0,0,0,0,0,16,0,0,0,16,0,0,0,16,0,0,0,16,0,0,16,
16,0,0,0,0,0,0,0,0,0,0,0,16,0,0,0,16,0,0,0,16,0,0,0,0,0,0,0,16,0,0,0,16,0,0,0,16,0,0,0,0,0,0,0,0,0,0,0,16,0,0,0,0,0,0,0,0,0,0,0,0,0,0,16,
16,0,0,0,16,0,0,0,16,0,0,0,16,0,0,0,16,0,0,0,16,0,0,0,0,0,0,0,0,0,0,0,16,0,0,0,16,0,0,0,16,0,0,0,0,0,0,0,16,0,0,0,0,0,0,0,0,0,0,0,16,0,0,16,
16,0,0,0,16,0,0,0,16,0,0,0,16,0,0,0,16,0,0,0,0,0,0,0,0,0,0,0,16,0,0,0,16,0,0,0,0,0,0,0,0,0,0,0,0,0,0,0,16,0,0,0,0,0,0,0,0,0,0,0,0,0,0,16,
16,16,16,0,16,16,16,0,16,16,16,16,16,16,0,16,16,16,16,16,16,0,0,0,0,0,0,0,16,0,0,0,16,0,0,0,16,0,0,0,16,0,0,0,0,0,0,0,16,0,0,0,0,0,0,0,0,0,0,0,16,0,0,16,
16,0,0,0,16,0,0,0,16,0,0,0,16,0,0,0,0,0,0,0,0,0,0,0,0,0,0,0,0,0,0,0,16,0,0,0,16,0,0,0,16,0,0,0,16,0,0,0,16,0,0,0,0,0,0,0,0,0,0,0,16,0,0,16,
16,0,0,0,16,0,0,0,16,0,0,0,16,0,0,0,16,0,0,0,16,0,0,0,0,0,0,0,16,0,0,0,16,0,0,0,16,0,0,0,0,0,0,0,16,0,0,0,16,0,0,0,0,0,0,0,0,0,0,0,16,0,0,16,
16,0,0,0,16,0,0,0,16,0,0,0,16,0,0,0,16,0,0,0,16,0,0,0,0,0,0,0,16,0,0,0,16,0,0,0,16,0,0,0,16,0,0,0,0,0,0,0,16,0,0,0,0,0,0,0,0,0,0,0,16,0,0,16,
16,0,0,0,16,0,0,0,0,0,0,0,16,0,0,0,0,0,0,0,16,0,0,0,0,0,0,0,16,0,0,0,16,0,0,0,16,0,0,0,16,0,0,0,0,0,0,0,0,16,16,16,16,16,16,16,16,0,16,16,16,16,16,16,
16,0,0,0,16,0,0,0,16,0,0,0,16,0,0,0,16,0,0,0,16,0,0,0,0,0,0,0,0,0,0,0,16,0,0,0,16,0,0,0,16,0,0,0,16,0,0,0,16,0,0,0,0,0,0,0,16,0,0,0,16,0,0,16,
16,0,0,0,16,0,0,0,16,0,0,0,16,0,0,0,16,0,0,0,16,0,0,0,0,0,0,0,16,0,0,0,16,0,0,0,16,0,0,0,16,0,0,0,16,0,0,0,16,0,0,0,16,0,0,0,0,0,0,0,0,0,0,16,
16,0,0,0,16,0,0,0,16,0,0,0,0,0,0,0,16,0,0,0,16,0,0,0,0,0,0,0,16,0,0,0,16,0,0,0,16,0,0,0,16,0,0,0,16,0,0,0,16,0,0,0,16,0,0,0,16,0,0,0,16,0,0,16,
0,0,16,16,16,0,0,0,16,0,0,0,16,0,0,0,0,0,16,16,16,16,16,16,0,16,0,16,16,16,16,0,16,16,0,16,16,16,16,16,16,16,16,0,16,16,16,16,0,16,0,16,0,16,16,16,16,16,16,16,16,0,16,16,
16,0,0,0,16,0,0,0,16,0,0,0,16,0,0,0,16,0,0,0,16,0,0,0,0,0,0,0,0,0,0,0,16,0,0,0,16,0,0,0,0,0,0,0,16,0,0,0,16,0,0,0,16,0,0,0,16,0,0,0,16,0,0,16,
16,0,0,0,16,0,0,0,16,0,0,0,16,0,0,0,16,0,0,0,16,0,0,0,0,0,0,0,0,0,0,0,16,0,0,0,16,0,0,0,16,0,0,0,16,0,0,0,16,0,0,0,16,0,0,0,16,0,0,0,16,0,0,16,
0,0,0,0,16,0,0,0,16,0,0,0,16,0,0,0,0,0,0,0,16,0,0,0,0,0,0,0,16,0,0,0,0,0,0,0,16,0,0,0,16,0,0,0,16,0,0,0,16,0,0,0,16,0,0,0,16,0,0,0,16,0,0,16,
16,16,16,0,16,16,16,16,16,0,16,16,16,16,16,16,16,0,16,16,16,0,0,0,0,0,0,0,16,0,0,0,16,0,0,0,16,0,0,0,16,0,0,0,0,0,0,0,16,0,0,0,16,0,0,0,16,0,0,0,16,0,0,16,
16,0,0,0,16,0,0,0,16,0,0,0,16,0,0,0,16,0,0,0,16,0,0,0,0,0,0,0,0,0,0,0,0,0,0,0,16,0,0,0,16,0,0,0,16,0,0,0,16,0,0,0,16,0,0,0,16,0,0,0,0,0,0,16,
16,0,0,0,16,0,0,0,16,0,0,0,16,0,0,0,16,0,0,0,16,0,0,0,0,0,0,0,16,0,0,0,16,0,0,0,0,0,0,0,16,0,0,0,16,0,0,0,16,0,0,0,16,0,0,0,16,0,0,0,16,0,0,16,
16,0,0,0,16,0,0,0,0,0,0,0,16,0,0,0,16,0,0,0,16,0,0,0,0,0,0,0,16,0,0,0,16,0,0,0,16,0,0,0,0,0,0,0,16,0,0,0,16,0,0,0,16,0,0,0,16,0,0,0,16,0,0,16,
16,0,0,0,16,0,0,0,16,0,0,0,16,0,0,0,16,0,0,0,16,0,0,0,0,0,0,0,16,0,0,0,16,0,0,0,16,0,0,0,16,0,0,0,16,0,0,0,16,0,0,0,16,0,0,0,16,0,0,16,16,16,16,16,
16,0,0,0,16,0,0,0,16,0,0,0,16,0,0,0,16,0,0,0,16,0,0,0,0,0,0,0,16,0,0,0,16,0,0,0,16,0,0,0,16,0,0,0,16,0,0,0,0,0,0,0,16,0,0,0,16,0,0,0,16,0,0,16,
16,0,0,0,0,0,0,0,16,0,0,0,16,0,0,0,16,0,0,0,16,0,0,0,0,0,0,0,16,0,0,0,16,0,0,0,16,0,0,0,16,0,0,0,16,0,0,0,0,0,0,0,16,0,0,0,16,0,0,0,16,0,0,16,
16,0,0,0,16,0,0,0,16,0,0,0,16,0,0,0,16,0,0,0,16,0,0,0,0,0,0,0,16,0,0,0,16,0,0,0,16,0,0,0,16,0,0,0,16,0,0,0,16,0,0,0,0,0,0,0,0,0,0,0,16,0,0,16,
16,16,16,16,16,0,0,0,16,0,0,0,16,0,0,0,0,0,0,0,16,0,0,0,0,0,0,0,16,0,0,0,0,0,0,0,16,0,0,0,16,0,0,0,16,0,0,0,16,0,0,0,16,0,0,0,0,0,0,0,16,0,0,16,
16,0,0,0,16,0,0,0,16,0,0,0,16,0,0,0,16,0,0,0,16,0,0,0,0,0,0,0,16,0,0,0,16,0,0,0,16,0,0,0,16,0,0,0,16,0,0,0,16,0,0,0,16,0,0,0,0,0,0,0,16,0,0,16,
16,0,0,0,0,0,0,0,16,0,0,0,16,0,0,0,16,0,0,0,0,0,0,0,0,0,0,0,16,0,0,0,16,0,0,0,16,0,0,0,16,0,0,0,16,0,0,0,16,0,0,0,16,0,0,0,16,0,0,0,16,0,0,0,
16,0,0,0,16,0,0,0,16,0,0,0,16,0,0,0,16,0,0,0,16,0,0,0,0,0,0,0,16,0,0,0,16,0,0,0,16,0,0,0,16,0,0,0,0,0,0,0,16,0,0,0,0,0,0,0,16,0,0,0,16,0,0,16,
16,0,0,0,16,0,0,0,16,0,0,0,0,0,0,0,16,0,0,0,16,0,0,0,0,0,0,0,16,0,0,0,16,0,0,0,16,0,0,0,16,0,0,0,16,0,0,0,16,0,0,0,16,0,0,0,16,0,0,0,16,0,0,16,
16,0,0,0,16,0,0,0,0,0,0,0,16,0,0,0,16,0,0,0,16,0,0,0,0,0,0,0,16,0,0,0,16,0,0,0,16,0,0,0,16,0,0,0,16,0,0,0,16,0,0,0,0,0,0,0,16,0,0,0,16,0,0,16,
16,0,0,0,0,0,0,0,16,0,0,0,0,0,0,0,16,0,0,0,16,0,0,0,0,0,0,0,16,0,0,0,16,0,0,0,16,0,0,0,16,0,0,0,16,0,0,0,16,0,0,0,16,0,0,0,16,0,0,0,16,0,0,16,
16,0,0,0,16,0,0,0,16,0,0,0,0,0,0,0,16,0,0,0,16,0,0,0,0,0,0,0,16,0,0,0,16,0,0,0,16,0,0,0,16,0,0,0,0,0,0,0,16,0,0,0,16,0,0,0,16,0,0,0,16,0,0,16,
16,16,16,16,16,0,0,0,16,0,0,0,16,0,0,0,16,0,0,0,16,0,0,0,0,0,0,0,0,0,0,0,16,0,0,0,16,0,0,0,16,0,0,0,16,0,0,0,16,0,0,0,16,0,0,0,16,0,0,0,16,0,0,0,
0,0,0,0,16,0,0,0,16,0,0,0,16,0,0,0,16,0,0,0,16,0,0,0,0,0,0,0,0,0,0,0,0,0,0,0,16,0,0,0,16,0,0,0,16,0,0,0,0,0,0,0,0,0,0,0,16,0,0,0,16,0,0,0,
16,0,0,0,16,0,0,0,16,0,0,0,16,0,0,0,16,0,0,0,16,0,0,0,0,0,0,0,16,0,0,0,16,0,0,0,16,0,0,0,16,0,0,0,16,0,0,0,0,0,0,0,16,0,0,0,16,0,0,0,16,0,0,16,
0,0,0,0,16,0,0,0,16,0,0,0,16,0,0,0,16,0,0,0,16,0,0,0,0,0,0,0,16,0,0,0,16,0,0,0,16,0,0,0,16,0,0,0,16,0,0,0,16,0,0,0,0,0,0,0,16,0,0,0,16,0,0,16,
16,0,0,0,16,0,0,0,16,0,0,0,16,0,0,0,16,0,0,0,16,0,0,0,0,0,0,0,0,0,0,0,0,0,0,0,16,0,0,0,16,0,0,0,16,0,0,0,16,0,0,0,16,0,0,0,16,0,0,0,0,0,0,16,
16,0,0,0,0,0,0,0,16,0,0,0,0,0,0,0,16,0,0,0,16,0,0,0,0,0,0,0,16,0,0,0,16,0,0,0,16,0,0,0,16,0,0,0,16,0,0,0,16,0,0,0,16,0,0,0,16,0,0,0,16,0,0,16,
16,0,0,0,16,0,0,0,16,0,0,0,16,0,0,0,16,0,0,0,16,0,0,0,0,0,0,0,16,0,0,0,0,0,0,0,16,0,0,0,16,0,0,0,0,0,0,0,16,0,0,0,16,0,0,0,0,0,0,0,16,0,0,0,
16,0,0,0,16,0,0,0,16,0,0,0,16,0,0,0,16,0,0,0,16,0,0,0,0,0,0,0,16,0,0,0,16,0,0,0,16,0,0,0,16,0,0,0,16,0,0,0,16,0,0,0,0,0,0,0,16,0,0,0,16,0,0,16,
16,0,0,0,16,16,16,16,16,0,16,0,16,16,16,16,16,16,16,16,16,16,16,16,16,0,16,16,16,0,0,16,16,16,16,16,16,16,16,16,16,16,0,16,16,0,0,0,16,0,0,0,16,0,0,0,16,0,0,0,0,0,0,16,
16,0,0,0,16,0,0,0,16,0,0,0,16,0,0,0,16,0,0,0,16,0,0,0,0,0,0,0,16,0,0,0,16,0,0,0,16,0,0,0,16,0,0,0,16,0,0,0,16,0,0,0,16,0,0,0,16,0,0,0,0,0,0,16,
16,0,0,0,0,0,0,0,16,0,0,0,16,0,0,0,16,0,0,0,16,0,0,0,16,0,0,0,0,0,0,0,16,0,0,0,16,0,0,0,16,0,0,0,0,0,0,0,16,0,0,0,16,0,0,0,16,0,0,0,0,0,0,16,
16,0,0,0,16,0,0,0,0,0,0,0,16,0,0,0,0,0,0,0,16,0,0,0,16,0,0,0,16,0,0,0,0,0,0,0,0,0,0,0,16,0,0,0,16,0,0,0,16,0,0,0,0,0,0,0,16,0,0,0,0,0,0,16,
16,16,16,16,16,16,16,16,16,16,16,16,0,16,16,16,0,16,16,16,16,16,0,16,16,16,16,16,16,0,16,0,0,16,16,0,16,16,16,16,16,16,16,16,16,16,16,16,16,16,16,16,0,16,16,16,16,16,16,0,16,16,16,16,
16,0,0,0,0,0,0,0,0,0,0,0,16,0,0,0,0,0,0,0,16,0,0,0,16,0,0,0,16,0,0,0,16,0,0,0,16,0,0,0,0,0,0,0,16,0,0,0,16,0,0,0,0,0,0,0,16,0,0,0,0,0,0,16,
16,0,0,0,16,0,0,0,16,0,0,0,16,0,0,0,16,0,0,0,16,0,0,0,16,0,0,0,16,0,0,0,16,0,0,0,16,0,0,0,16,0,0,0,16,0,0,0,16,0,0,0,16,0,0,0,16,0,0,0,0,0,0,16,
16,0,0,0,16,0,0,0,16,0,0,0,0,0,0,0,16,0,0,0,16,0,0,0,16,0,0,0,16,0,0,0,16,0,0,0,16,0,0,0,16,0,0,0,16,0,0,0,16,0,0,0,16,0,0,0,16,0,0,0,0,0,0,16,
16,0,0,0,16,0,0,0,16,0,0,0,16,0,0,0,16,0,0,0,16,0,0,0,16,0,0,0,16,0,0,0,16,0,0,0,0,0,0,0,16,0,0,0,16,0,0,0,16,0,0,0,16,0,0,0,16,0,0,0,0,0,16,16,
16,0,0,0,0,0,0,0,16,0,0,0,0,0,0,0,16,0,0,0,16,0,0,0,16,0,0,0,16,0,0,0,16,0,0,0,0,0,0,0,16,0,0,0,16,0,0,0,16,0,0,0,16,0,0,0,16,0,0,0,0,0,0,16,
16,0,0,0,0,0,0,0,16,0,0,0,16,0,0,0,16,0,0,0,16,0,0,0,16,0,0,0,16,0,0,0,16,0,0,0,0,0,0,0,16,0,0,0,16,0,0,0,0,0,0,0,16,0,0,0,16,0,0,0,0,0,0,16,
0,0,0,0,16,0,0,0,0,0,0,0,16,0,0,0,16,0,0,0,16,0,0,0,16,0,0,0,16,0,0,0,16,0,0,0,0,0,0,0,16,0,0,0,16,0,0,0,16,0,0,0,16,0,0,0,16,0,0,0,0,0,0,16,
16,16,16,0,0,0,0,0,16,0,0,0,16,0,0,0,16,0,0,0,16,0,0,0,16,0,0,0,16,0,0,0,16,0,0,0,0,0,0,0,16,0,0,0,0,0,0,0,16,0,0,0,0,0,0,0,16,0,0,0,0,0,0,16,
16,0,0,0,16,0,0,0,16,0,0,0,16,0,0,0,16,0,0,0,16,0,0,0,16,0,0,0,16,0,0,0,0,0,0,0,0,0,0,0,0,0,0,0,0,0,0,0,16,0,0,0,16,0,0,0,16,0,0,0,0,0,0,16,
16,0,0,0,0,0,0,0,16,0,0,0,16,0,0,0,16,0,0,0,16,0,0,0,16,0,0,0,16,0,0,0,0,0,0,0,0,0,0,0,0,0,0,0,0,0,0,0,16,0,0,0,16,0,0,0,16,0,0,0,0,0,0,16,
16,16,16,16,16,16,0,16,16,16,16,16,16,16,16,16,16,16,16,16,0,16,16,16,16,16,16,16,16,16,16,16,16,16,16,16,16,16,16,16,16,16,16,16,16,16,16,16,16,16,16,16,16,16,16,16,16,16,16,16,16,16,16,16,
